..................................................
..................................................
.......####.......................................
....................##............................
..................................................
..................................................
.................................................
..................................................
...####...........................................
..................................................
......................o...........................
......................o...........................
.....................###..........................
..................................................
..................................................
............####..................................
..................................................
.$................................................
..................................................
##################################################