..................................................
...................................####...........
.......####.......................................
....................##............................
..................................................
..................................................
...............................####...............
..................................................
...####...........................................
..................................................
......................o...........................
......................o............###............
.....................###..........................
..................................................
..................................................
............####..................................
......................................####........
.$................................................
..................................................
##################################################